BBBBBBBBBBBBBBBBB
B    EEEE  EEE  B
B BEBEB B BEBEB B
BEEEEE  E EEEEE B
BEB BEBEBEBEBEBEB
BEE   EEEE   EEEB
BEBEBEB BEB BEB B
BEEEEE   EE EEE B
BEB BEB BEBEBEB B
B   EEEEEE  EE  B
BEBEBEBEBEB BEBEB
BEEEE   EEE  EEEB
BEBEB BEBEBEBEBEB
B  EEEEE  EEEEEEB
B BEBEB B BEBEB B
B EEE   E EEE   B
BBBBBBBBBBBBBBBBB
