BBBBBBBBBBBBBBBBB
B   EEE    EEE  B
B BEB BEB BEB B B
B EE   EEEEE  EEB
BEBEBEBEB BEBEBEB
BEEE   EE   EEEEB
BEBEB BEBEBEB BEB
B   EEE   EEE   B
B BEBEBEB BEBEBEB
BEEEE   E EEE   B
BEB BEB BEBEBEB B
B   EEE EEE   EEB
BEBEBEBEBEB BEBEB
B  EE EEE EEEEEEB
B BEB BEB BEBEB B
B E   EE  EEE   B
BBBBBBBBBBBBBBBBB
